R 620 400
NO ./src/texture/doom1.xpm
SO ./src/texture/doom2.xpm

WE   ./src/texture/doom3.xpm

EA ./src/texture/doom4.xpm
S ./src/texture/sprite.xpm
C 65,93,106
F 24,42,120 
        1111111111111111111111111
        1000000000110000000000001
        1011000001110000022220001
        1001000000000000000000001
111111111011000001110000000000001
100000000011000001110111110111111
11110111111111011100000010001
11110111111111011101010010001
11000000110101011100000010001
10002000000000001100000010001
10000000000000001101010010001
11000001110101011111011110W0111
11110111 1110101 101111010001
11111111 1111111 111111111111
